111111111
1P0C001E1
1110C0C11
1C0CC0101
111111111
111111111
